[
  {
    "type": "mapgen",
    "om_terrain": "thae_home_field",
    "object": {
      "fill_ter": "t_region_groundcover",
      "rows": [
        "123123123123123123123123",
        "231231231231231231231231",
        "312312312312312312312312",
        "123123123123123123123123",
        "231231231231231231231231",
        "312312312312312312312312",
        "123123123123123123123123",
        "231231231231231231231231",
        "312312312312312312312312",
        "123123123123123123123123",
        "231231231231231231231231",
        "312312312312312312312312",
        "123123123123123123123123",
        "231231231231231231231231",
        "312312312312312312312312",
        "123123123123123123123123",
        "231231231231231231231231",
        "312312312312312312312312",
        "123123123123123123123123",
        "231231231231231231231231",
        "312312312312312312312312",
        "123123123123123123123123",
        "231231231231231231231231",
        "312312312312312312312312"
      ],
      "//": "1: reserve for furniture. 2: reserve for terrain. 3: reserve for items.",
      "terrain": {
        "1": "t_region_groundcover",
        "2": [ [ "t_region_groundcover", 1000 ], [ "t_region_shrub_plains", 30 ], [ "t_region_tree", 2 ] ],
        "3": "t_region_groundcover"
      },
      "furniture": {
        "1": [
          [ "f_null", 1000 ],
          [ "f_region_plain", 100 ],
          [ "f_boulder_small", 10 ],
          [ "f_boulder_medium", 8 ],
          [ "f_boulder_large", 2 ],
          [ "f_region_flower", 5 ]
        ],
        "2": "f_null",
        "3": "f_null"
      }
    }
  }
]
